0,150
112,147
61,116
89,63
66,61
64,38
41,38
123,6
55,25
113,116
111a111111011111101111110101111111101110011a011111111101010110111111111011011101101001001111111111110111001122b002100120022002011211212112111011101110000111111
101a111101111110111111111111111111111111011a101111111011101101111111011110110111111111011111111111111111110021a1210021211210111220002021020111011110111110111111
010a111111101111101110111111111101111101011a111110111101111011101111011010111111111111111001011110111101111111a2121111211212222002122110211110111111110011111111
111a110110111111110111111010111111111101111a110111111110111111111110111011111111110111111111101111111111011111a1201122211111110110111111111101101111111001110111
011a111011110011000011111111110010111101100a111110110111111011111011100111111111111111111111011111000111111110a1111111111111101111111111101111011111111111111101
111a111101011111110101110010101111111111111a111101011111111111111110111111111111111001110101011100101111111112b2121111201212002101122111212111111111111111110001
111a111111111111000111101111110111111110100a111101110111111001111110101011111100111011111111111111001111111120a1210110221212221222111121121111111111111111010101
111a111111101011111111111111111101101101011a101111111111101101111111111111111111111011111011011111101110110021b1221122111222201111221111021011111110111011111111
110a111101101111110101111100110110011001111a111111111101111111111111111111111011111111100111111111111111111011b1101111020210221112101111212101111010101111111111
100a111011110111111011011101111111100111010a110101111101011111110110011011111111110111111111111111111111111120a1121112100210111121022121220101111110111010110111
101a011111111111101101011110101111100111102a001011112112120011212211222111111011111001111111101111111111111101b1221120221202211022122111121111111101110111011111
111a011111101110111111111011111111011011120a221210210112121010211221112101111111111101111111100111101111011121a0121010111221110122121020120011000001111100110101
111a111111111111111111111011101111111111201a020110210011110112211121222111110011101101110101001111111111111111b1221020101120011002221101121111111111111111011101
101a111111110011011111101110111111110111101a201212110011200210102220012101100111001111110111111111110111011012a2220122221022221212020101122101011111111111100101
011a100010111011011101110111111111111001201b221112111110210201212102020111111111110111111011111011111101101122b1211120211210011221212111212101011011101111101111
111a101111111101111110110111111111111111211b121020020102101122011022122110111111111010111111111110011110110101b1111112211020221021221011222100111111111101011110
111a001011111110110111111111100111111111102b201000112112121122210202120111111010110111111111001111111110110120b2221111020220121111122121211111010011011111111111
101a111111111101111111011111011111111111022b111220201110202021210000021111111100110111100111111011111111011021b1111122220222112201111121010110111110111101111110
111a111111111111111111111101011111111111002b121201200011121211100001202111110111011010111111101111111111110102b2001112111112002120221111022111100011110111111011
110a111111111110111101101111100111111111221b211222121011210012100110022011111011101111111100111011111111101111b2121112020011222222212121210111111110100110011001
111a111001110110111111111111111101101111111a010111111111011101001111001111110101111011111111110011111111111111a1111110101111110011010101011111111111111011001111
011a111111011101111111111001110111011110211a121201100211111122212012011011111111110111111111011111111111011102a1121102111101212121202221121101110110111110101111
111a011010111101111101110110111101111111222b221111012211012211211211121111100110111111110110010111111111111010a1011111111111111101111011111111111101111110111111
101a101011101100011111111112120202100120120b221222222211001111222122212222101112101111111111101111110111111111a1110011110111111111011111111011111110111001100111
111a111111111111101111001112202220112112011b222220220212020211121221211121121112111101011001011111111011111110a1011111011111101111010111011111111011111111101101
101a110101101111100111011112202122122020221b021022121212210211222211212122012100110111111111101011111111111011a0101111011110111110111101011101001111111110110101
111a100111011111111110111111121121120222222b222222220212202112212222201220112212111111111011111111111101111111a1011001111011010111111111111001111110111100111111
011a011110110110110111111100211110111201010b122221200010221101222222222221112012111111100111101111110110101111a1111010111111111101111111110111111111111111111110
111a111111101011111100101110220200122121222b222202022212222210100111111011111101011111101111111111111110111111a1011111101101111101111111111000110011100110111111
111a111111110011111100011012221120122021222b200122022210222112222221112222120011111111110111110010111110111011a1001111111011111101111101111101111011011111111101
101a011111111101110110111110012121122022002b221222222210212212222212022202121112101111110011111111111011101110a1111111101001111111110101111010110111110111011111
011a111001110111011001011111111111122201022b202212221200222110210112212111002010111111111111101111110111101011a1111111111011111101111101111110111111010011001111
111a110111111101111111011111102212021110222b201120222212220210222200222022110112111110111011111110111101101110a1101111011101111111011101111111100111011011111111
001a111111111011111011101112212201112000222b122212222212112212222221000210221101001110101111110111110111001111a1100110101011101011001111110101111011111111111111
111a010011111111011111101101101111121220100a012021122212211212212202202122100200100100111011011001111110111010a0000111111111111110111001101011110111011010111111
111a111011111111111111111111212111112122010b000022002112202212022222121122022212111110111111111111111111111111a1111100111111111010111111111111110110101111111110
111a111111111100101111110101220112100120001a222022221102221201001202122120021212110110111101111111111011100111a1101111011111111001011110101111111111110111111010
111a101101111110111111100011220200120101222b222220202212121212222222020212221211111111101111111111111011111101a1111111001111011111110111010011111000111111011111
111a111110111111111111111111222202021222121b022002222212122211222211022222001212000101110010111111111110101111a0110111110011110101110111111101011100111111011111
111a111010111111111111111111212222101112221b012222202211202012222222022222212111111111011110111111111111111111a1001011110100101111001001111111110110110111111111
111aaaaaaaaaaaaaaaaaaaaaaaaaaaaaaaaaaaaaaaaa101111111111111111111011101111101110111111111111110111111111111101a1111101111100010010111110111101111011110111011111
11111011100111111111111111111111011201111222212010021212212112020212122002121110111111111111101111010110111011a1111100111111110111011110011001111101011110111111
11111111011111111001101111222222101121012212001212220211111112212021221221101212110110110011010111110111011111a1011111011111111011011111111111111110111110111101
11111111111111111100111110101210021212102022220122221010212102210222122221211111111111101111111011111110111010a0111100111111110111111100110111101011001111111110
01111111101011111101101111001021121222202002012012122200021102122202211020101212011111111111011111111100111101a1111111111111111110110110110110001111111011111111
11111011111111111101101111120221210202222202122022220012222102221020210112011111011111110101111101111111011111a1111101101111011111111111011111111110111011101110
11111111111111111111111111222222221222201222211112200212200111212220222202202010111111101101111111111111110111a1111111111111110101101111111001101111111011111111
11110111010111011001111000211222201202210201121012120212200102222222222112220202120111111111111110110111100111a1111110111111111111111110110111111111100111110011
10011011111111110111111111011111101111011001101011101111011011011101111110101010101011212212222022121122111111a1111111111011101111110111111111101111111001110111
11111101111110111111011110111011101110101111110111111111111111111010111011111111011111110111110011111122210111a1101111101011111101111111101111111111111111011111
11011011110110011001111110221112111211110112012011120212020010212122112202022211111111110101111111101010110111a1011111010001110111111111111110011111111101100111
01110011111110011101111011212011221201021211211202202210222112002000111221222211221021100200202222121101011110a1111110111111111111101110111101111111111110111111
10111111110000011111110111221122211112211221021110222202202112012222120100222210221101222220122111111121211001a1111111111000111111111111101111111100111111101111
11110110101111110011101110222122121212210212200212122212020010221110222221220201202121212211112012211102111111a1111101001101110111100111111111111111001100111010
01100111110111111101111001111101011111111110111000102001201111222020101102121011212112212111222211021011011110a1111001010100101111111011111111101100111111101111
11110110111111010101011101111111010111111101011111112210110110020212112012202011222122120121111111201122001111a1101011111111111111011010111101111111111111001110
11111111111111111111111011111111001111011111101100111212222111201212202210222200222111112222021122011211111111a0101110110111101111111100010111111111111101010001
11111111111011111111101111111111001001111111110111010012222112102222121102222210221121201212102110021112011101a1101111111110111111111111111111111111111111111110
11010110111110001111110110110111101000111110101110120000011112102201022212222211200222022112212120221022211111a1001010101101111111111011111100101111111111101111
11101110011111110111111110011111110110011111101111112212122111212200122212222211022222202212020121211111111011a1101011110111001111011001100010000111011111101111
11110111110111111111111101001110111111011001001111111100222102122212200222220210111101001111101010101111110111aaaaaaaaaaaaaaaaaaaaaaaaaaaaaaaaaaaaaaaaaaaaaaaaaa
1110100111110111111110111111110111010111111101011101201212110212202112122000022000022220222121222120121121011111111101111101111111111111011110101111101011111011
1110001110111110111111110110111111111101111011110110111111111111011011011011011111101011011111101110111111011111011100111111011111110101111111101111010111111110
1111101111111111111111111111111111010111111101111101111111011112220110102220220102211221120202202111121110111111111111101110011001111101111111111111111101110111
aaaaaaaaaaaaaaaaaaaaaaaaaaaaaaaaaaaaaaaaa11111101101121111110012222211210211222122222211222012022211021221101111011110111111011110111110111101101011111100111111
1101110111111110111100111111011111011111a11101000012022011121120112122201100222122111222111210122110012121101111111111011111111110111011110111011111010110100111
0011111111111011111011011101111111110111a01111011111221212211121220222111222112122020221222111221121121221111111011111010001111100111111011111111111111111111111
0011011111110111111011111011111111101011a11001101011220010121221102110220122122102121221012122220221111220101111101000111111111111101111111011111011111111011011
0111011011101110111111110111111011100111a11111111011020211201112022212220002122121102121112111111010011211111111110011111110101110111111011111111011111011110111
1111111101111111111101010011111111001111a11111111001111111111222212222222022220122221201011202221220121101111111101110011111111111111111111111111111101011110011
1010111111111111010101111111110111111110a11111111110212212001221222211221222122122102112121011221121100010100110111111111111010101111101111111111110011011111111
1011111111011110111111111111101101110111a11111010102021122221111101101112120221122122120212110222221122110111111111011111111111111111110111111011111111111111011
0110111111110110111101111111111110110111a01010111111001112211112011222222012220122111211121221111021122111101111011110101110111111110111011011111111110110000110
1011101110111111100111110111110001111111a11010111102220101211122202211122222122010220112221220121010111120111111110111111101101111111111100110111101110111011111
0111011011011010111111101010111111111111a11111110110222222221202220122112212221022121221202102120012211211010101101111111110111100101110011111110111101110110111
0111011111111101111110110111111111111101a10111110110122202121212100121102122020120221222222200110102200220010111110111111111111111111110101101111101111011001111
1101101111110111110011110111111111000111a11100111101222201111122210020222221020022122201210021111101122121010111101111100111111100011101111011111110011011111111
1110101101010101111101111111111111111101a111111011111100101101011011110101111220210222122221122112211011111110111111101aaaaaaaaaaaaaaaaaaaaaaaaaaaaaaaaaaaaaaaaa
1101110111011101111011111101100111111111a011011111100111110011100111101100110121220221210112121120002002111111111011111a1111101111111110111111111111110111111111
1111111111011011110010110111111111110111a111111111111111111110010111011111111110111101101111101111001111111001101100010a1011111011111110111010110110111111111111
1001111011110111011101101111101011110111a111111111010111101011101110011111101111011001111110111111011110011111111111001a1011101101111011111101111111111011111111
1111001110101111111111111111111111111100a111011100111111111111111111110111001111111111111111111111110001111110111110111a1011111101011100111111110111111111111111
1111111011111111011011101111110111111101a110111010111111111100111101111101110111011011010110110101111111111001111011111a1011111110111111101000110111011111111111
0011111101111111101111101110110011111010a101111001011110111111101110111101110111111111101101011111111111111111110111111a1111011111010001111111110111101101111111
aaaaaaaaaaaaaaaaaaaaaaaaaaaaaaaaaaaaaaaaa011111111110111111111011111011111010101111111110111011001111101111110111101110a1101100111110010110111111111111111111110
11111100111011010111111111110001111111110111011111011111111111111110110001100111110110111111111111111111011111111101001a1111101111111111111111101111111101101101
11001111010011111101101111011011101101011111111101001111101111111111101111001101111011111111111101110011111111101111101a1011111111111101111111101011111111010111
11111011011101101010111101111110110101111100110111111110111011111111111111111111011101111101111111111111110110010011111a1111111101111111101111101111111111010001
10011001110011010101110111101101011110111101111001011011111111110111111111010011111111111111010111111111111000111111110a1101100110111111101101110110001110011101
01110011101111111111000111111111111111111111011111111101011111111111011111101111111111101111101111101110111111111110111a0011111111111111101101111111111111111111
00111110111011111111111111101011111110101110011111100011111111111011111111111111011111111011101111111111001101111111111a1010111111110111111111011111111111011011
10111111111101110111111111110111100111110111011101111011001111011111111100110100101111110100111010101101111111011111101a1100111111111011110000011010111111111110
11111011111111111011111101111100111111110011111001110110111110001111110111100011111111111111110110101111110111111111011a0001101111110110111111111111110001011100
11111111011111101111111011111111111011110110011111111111110111011101111111011010111001101110111111111001110110011011110a0111011111011111101111101011111111111011
11100111111111111001011111101010111011111111111111111110011111111111111101111011111111101111111111111111100100111111111a1111101111101111110010111101111111111000
01010110111111111111101111111111111111011101111111111101100101111001111111111101111110111010111111111111111111111111101a1111111111101111101011101100110111101111
11100111111111011010111111101111111001011111111111111101101111001111111101110111111011011111101111111111111101111111111a1110111110001111010111011101110101111001
aaaaaaaaaaaaaaaaaaaaaaaaaaaaaaaaaaaaaaaaaaaaaaaaaaaaaaaaaaaaaaaaaaaaaaaaaaaaaaaaaaaaaaaaaaaaaaaaaaaaaaaaaaaaaaaaaaaaaaaa1111010111010110111111111011110111111111
0110100011111111111110111111100111010111101110111111110001101110010111110010011111110111111110110110111111111011111111011011111111111111111111101111111110101111
0111111111111111011011110100110010110111011111110111101100111100111101001111111100110011010111111011111010111111111111111111101111111011111011011111101111011111
1011111101111111111111111111011111111111000111110111110111111111111111111110101011010111111111011111111111001011111110111011101110101111111111011111011011111111
1111111011101111011111100110111101111111111111211101011112001201122212021211210111011111010111111112011001111201100121010111212021111110101111111010101111111011
1110111111001111101101100111111111111111111110222020221220220212022100220111111101010111011111111120102221112212111022211102222100111111111111100111111011101000
1111111101110111011101101101010001111111001111210011210022022202121111221202211101111011011011110012122211101211110111211222020011101111010110111111101011111111
1111111111111001111010100111001111111110111111111111110110010011101111111111111111101111011111011010111111110111111111111111110111111011110111111111111111110111
0010010111111110111111101111111111111111101100221012011121222221021121211021111110111011111110111121111221122001111022011010210121110011101110011111000111101111
0111111111111101111111110111111111110101100101222001110102220122221122121212111111011111011111101101202110221020101122211221021021111111111101111111110111111110
1011101111111111110011010011111110111111101101212122022121201112112112110000211111111011111111111122112221202200100110210202202021111111111111100111111111111111
1011010011010111110111111111111111110011111111222020112220221122121222121212211110111111110010010111012211201221112122000112012121111100111110111110011101011111
1111111101111011110111111111110111111011011110222222101100210020021012101010111111111110111110011111021011202112012201201100222221011110111111110111111010111110
1111110111111001111101010110111111001011111111111101110011111111011111110111001111110111111111100111111111111110001101001221111121110111111111101001110011111110
1100111101011111100011011111101111100101010100222222222110112011212021121212211101111111111111111110222200121200121212100022120021101111111111110111110111111111
111011011111111111101101111110110111011111101122212201221010222102222212112201110011111111101111110111210120202102112120222221111111010101111101101111111011111
1110111111111111111101111111011111101111111111201112220011222002210201111021010101101111101111111122121201012120110110212020201101111111111111111111111111111110
0111111110010110100111011111010111110111010101120002210012221221212001210012110110111111111110011122120121212112011111211122011201111111111111111110111011111111
1011111111111100010001001111110001101111011111111211111211122201112101201212101111110111111110111121112011202221120011002101022000111111111110111111101110111101
1110111111111111011111111111011101111101111111201220112212111211120212111122111111110111110111110122120021210222102111201120222221111111111111101100101101110111
1110111111111111111111111111111111011011010101111110022210211102220112021021211111111100111110111122122020121011122121002212212211110011100102100110111111100011
1111011111100010111101111111111001111111111111122022210212111110101022200220011101110101011111111122011221211222122210022020102121111111110111011111111111011111
1111111110111111111010110110111111111111110110122210211011222102212221221202211101111111101111111112221101202122012122101202211111111111111111111110111111010101
