119,159
0,0
19,76
81,95
129,98
47,18
127,90
35,33
117,54
80,27
111110101111011011111011111111110111111001001111111111111011110111110100110110011111111111111100111a011111111110101111111a1111110100110111110a110111101111110111
aaaaaaaaaaaaaaaaaaaaaaaaaaaaaaaaaaaaaaaaaaaaaaaaaaaaaaaaaaaaa11110011111110111111111111101011111111a011111011111111110111a1011111111101110110a111110011111111111
110111111111111111110011100011111111011111111011101111111010a11110011011111111111100001111001011111a111110101111111111110a1111111111110111111a01101110111111011
110101000110010110111111010101012212122121121121211110101211b01111111111001011010110001111101011100a110111111011011101111a1111111110111111111a110111111001001111
101111111011011111111111111111111122022222102221102221221212b11101101101111111101111011110010111110a110111110111111011101a0101001110101110101a111101111111111111
111111001111111111111011111111111111220120102121112220202212a20111111110010010011111111011111111111a111111111111111111011a1111110100111111011a111111111110011110
111111111111110111111111111110112010102222111121201011211100a21101010011111111101011101111100111111a111010111011111101001a0110111011100111100a111101111111111111
010010001011111011111111001110112110020111200221110220211010a00111111110111111011110111110111110100a101111111111111111111a1111010111010101111a111111111110100111
111101110110111101111001111110101221102222001120201212112212a11101111111001111110111111111010111111a011111111101111111001a0111001100110111110a101101111111110011
101111111111111101011111011111111012021211111221221122202011a21101110111010101111110111101111010110a111111111011111111101a1111101110111111111a101010111111111111
011111011011111100101111111111111220211110212211001021121111b11111111111110011110111111111111101111a011111001110101111101a1111111101110111111a011011011111111111
111111111101110111101111101001101112121120212121002211122112a21111010111111111100111111110111111010a111111111111110111011a1101110011011111110a111111101111110101
011111101111111101111000111111100211221111120121201121122201a211121211011200220abbbababbabbabbabaaaa111111111010011111101a1111111101100101101a110101010111111011
111111111011111111111111101111111210020121110221222111201112a211020011111222221a20102120121100221101111110111011111111111a0001001111111010001a111111011111111101
111001111111111110111110111111011112121011202221222211100012b211101202211111210a11102012120102111111111111111101110110101a1111111111111111011a111111011011101111
110111101101110111111111011010112121101111111210210112111211b111122112112112212a12102212122120021111011111111110111101111a1111100011011101111a111101111111111111
101111111110111111111111101110110221212120220101112011011202b211020211101022111a02211120110011201101110110111111011101111a1111011110111111111a11101101100111010
111111111111011111110011111111112221011210211221011200120010b001101011102122121a22212010121111111111110111111111011111100a1110111011111111111a101100101111111111
111110001011111101100110110121112002221222200220222210221211b211111210010221022a21112122021122021110110010111101001111111a0110111111011111011a111111111111111111
111111111001111110101011201121111022122020021001202101221112b110122112210220202a01122222102012011111101011011100111101111a1110111111111111111a111101010110101111
011101111011010001011111011111111111111111111110101110101101a110010112212201112a21222121111112121010111111010101111111111a1110111111111111111a111111111011111111
aaaaaaaaaaaaaaaaaaaaaaabbaaaaaaabaaabbbababbbbbaabbabbbbababa111122112111000201a21101222111112120001111111011111011111101a0111111111110001111a100110111011111111
1011111111111111111112022211100112122102221202002201112112112121012201111121111a21111120121112021011111111011100111111111a1111101110111101110a111111011101110101
1111111111111110101011201211121122222220002202012100122202112001122021111111212a20100102120022011111101111110111111111010a1101111111111111010a111001111111110001
1111110111111111111110112011122110220221012002210201121112110121121102100020202a11111111111111111111111101110111111111011a1101111111011111110a110101111111111101
1101101101001111101102112201020122222022211222211002122221112101122112111022121b21210201111102211011101100101111110111111a1111101111111111110a111101111101111101
0001111011111111001111212111122122222220022102210222000011112211122111112212221a22222122122022211111111111111110111011111a1101101001111111011a111111110111111101
1111111111001111111012110011001022211222222201211201222112022120121212111110212b21122112122121111110110011111011110111011a1111110110111111110a111100111111111101
0111011011111011101110112011122001200020221210112022010122102221112222202222112b21112211011210121010011100100110110111111a1011011101111111111a111010011111111110
1111111111111011111112022201010100221102201212212220011002122121102021211112022a00212111102012121111101111111110011111001a1111111111101111111a110110111111100110
1111101111111101101012221110102122220221222222210212221021111021112021212221202a02220212122012010101101001111111110010111a1111111011111110111a111101011111111010
1011111100111111110001202211112122122122122202212111201100022221112212211021202b22211021120212211101010011111111001111101a1011111110011110011a110110111101110000
0111111111101111111112200211112022122202220222212112102221101211121121112222210a22212221112210211101111111110111101011111a1111111111111111111a011111110111111011
0110101111101101101011121111102110212222122210212211222222110121012122210012222b01202102121211121011111101010101110111001a1111110111011111111a011111101110100111
1111111111111110111112022001121022102021121012211011111011100011120122012122210b10212110001220221011111011111101011100101a1101100110111101111a101111111110101111
1111111111011111111112210111022021102121020221201121101111111101111102012012210b10221222122122211111101101010111111111111a1100111111110111011a101101011011011110
1111110011101100110111111110111111111011122112202201111110011001121121112222122a10222011111102201111111111101111101101110a1011111001001111110a111111111111111111
1111011111110010101110002101110020112222102221210121111111110111021102212112222b22220012121221111011111111101101110111011a1111111111111111110a111111110101111011
1101111001111111111112211211112111121202121120211111011101100111122222012000121a22211121121020220111110111111011110111011a1110100101110110111a111011111110111110
1110111101011101111111102111101012211011001121111011111111001111111101101111011b12212201112221111111111101101110101110111a0011101111001111111a011111111110111111
0111101011111010111101111111110111101111111101111111111100111111111111111111101a11111111110222211101111111111111111111110abaabbaaaaabaaaaaaaaa110100011111101011
1010111110101101111110011111021110102220102100021200111111111111011102112112221b12212120002122121110111100112111010101112210112100211111110110111111110111000111
1111111111010111110112100122021120220122121122110221011111110110112002211212021a21101011112211111111011222001122122021111121202010202101011111111111111111011101
aaaaaaaaaaaaaaaaaaaaabbbbabaaabababaaabaa11210122011101111110011111011100111111a11111011111111111111111102112221212121212111022211120111111101111111101011101111
1111011001111111111112222121102112121112a12210022211110111111111111111111110111a10111111110101111111111111212110200101012222210110221111111111111111111111111111
1110111010111110011102222122121120201010a12022012110110111111111111101111111111a11111011100111111011102222212200120221112201201110212111011111111011101111110111
1111101111110111111111111011110110111111a01222122101110101111111101101011111110a11111101111111101101002201212201110101112101111111020111111111001101111111110011
1111111111100111111101202120122122220200a21111110021111111111110110111111101111a11011011111011101111111102211102102010102202001211221111111111111111100111111111
1101110000111111111112112201121122222222a10002121121111111111111101111011111111a10010111111101111111111011010111111111112022200211012111011101111111111110111011
1000011111111101011110111111111111111101a01111111001111111101111011101101101111a11111110111101100011102212000122100111212112211110112110111111111111011111111111
0111111111101111011011111111011111101111a11111111111111110111111100111111111110a11111011110110111111112211102111122211112100220011012001111110110011101111101101
1111111011111111111101100111011110110001a11011111110111011111100101111111111011a11111010101111111101101020012211012221210222110211221101111110110010001111111101
0100111011110011110111111110110011111111a11011111111111100111001111010111111111a11111111010111101111101222210111211200210111222211202101111111101111110111101111
0111111111111111111111111101110111111111a10101111011111111010011011110111110111a11011111111111110111101111212001111121212211121200121110110000111010111111110111
0011011111011101111100111111111111111111a11110111111111100111111101110111110111a10111101111101010111111221200112222220012120222011211110111110111011111110101111
1111001111111111111100011011110111011101a11011101101101110111110101110111111111a11110111111111001111112121112221200221101202211210222101110011111111111111111111
1111011111111011111111011100111001111111a10111111111011001111111011011000111111a11100111111011100111011122010121212211111202102111221111111101010111111111110111
1111001111110011111111111111110100111111a10111111111111001111111111111011101111a11110111111110101110111220110010010021210222112111222101110111110111011111011011
1111010111111111111111011111111101101111a10111111101111010111111100111110110010a11111111111110110110012121011122221111212211211211121110101111111111111111111110
1111111011101011111101011111111111111101a11110111111111111111011011111111001111a11111111011110111011011010111111111111101101111111101011111111110110101111111111
1011111110111111111111111111111110110111a11111111110111110010011111111011101101a11111111011111111111011111101111011111110111111111112101011111101101111111111101
0110101101220202220112200121111212101111a01101111111011111110111111111101011110a11111101111111101101110121211012112020011110111110110110111101111111101011011111
1001211122120022121200021221211001211001a10110111011111111111111111111001111111a10011011011111111111112221212012202111211221111221011111111111011111111111100111
aaaaaaaaaaaaaaaaaaaaaababbbbaababbbaaaaaa11101111111011101111111111101111111111a11011110111111011111112222202120202021211200222121211011111111101111011111111111
1111011010111011011111111111110111111111111101111111001001111011111011111101111a11111110011111111111010000211021002111111110022201121111111111111011100011111111
1101210112201202101211010221100011111111111110111101100001111001101010111110111a01110101110100111111111021212212201210211002011201120111111111100111110110110000
1111101211121200121211122212011220010111101111111111111110111111001011110111111a01001010001110111110110221112212001110111211122112202101111111011011111111100110
0101101110110111011012211110221011011101101111001011111111011111110111111111111a11111001111001111111112111211222200100101012122210202111100101111101111111111010
0111011011101111011112212211221221011111101011011111111111011011110111100111111a11101111111111111111111111001111111111111022210221022111111111011111111101110111
1010210212122221021210212112222210201111111111110010111111011111111110010111010a11111111101111101111102110211122122200111221210120111111011111011110011110101111
0011100100110011011111022112012122201011111011000111111100111111110111000111111a11111111111111111110111110101111111101111111110101111111111111011110111010111110
1111211221212222002111222112122221211010101110100100111101011111001111011011111a01011111111111111111111111111111101111111111111111101011111111111111111111111111
0101012022221212112112121121211202111011111101110101111010011011100111011101111a11100111101111111101111111011101111110110111111110101111110111111011111111110111
0111110020112122112110102012221210001111110111111101111111111111111110111111101a11011011111101111111111110111111011011110111110110011110111111011111111110001111
1111011111222010110011011011212201211111100111111101101111011111001011111111001a11111011111111100010001110111111001111111111101111100111111111111111111001010111
1101112220220221021110120012122212211101011010111101101111101111110011111011101a11111011111111111111101111111101111110011220222121110112112102101111111011111111
0100010212222212122211220210120210111111101111011101111011110110111111111111111a11101111111111111110111111111110011011010101110111110011100001111011011111101101
1111101111111111111112200221001122101101110011111111111000110111100111111011011a10111111111111111111001111111111121211010101012112222111202101111111011111111111
1111211212210201001101100112102222210110011111100111011000110110011111010110111a11101111111010111111111111011101012120011112022112121212200121111111110010111101
1011111111111101111111111111011011111111110111011111101011111111010111111111011a11111111101001111011011101111111111101110101110011111101111121101111011010110110
1111111111111111011011101111111111111011011111110011011111011101110111101101111a10001111110111111011100111111010111100010212212201001121211012111111110110110101
1111111111111111001100110110111111111011111101011111111110111111011111111111111b11000011211112211111110111111011221221211101111111111011111121111111111111011111
1111121212212102102011011112121012211111011100111111111111111111111211212212101b11200222021011222111001111110111120121202202120111102211212120110001111111111101
1111111011011111111111111111111111111110111001111101110101110111110002200121001a20221022001110221111101010111110011121212121220122012202010120012111010100011001
1111001112222111111110201220202202011011110111010111111111101111112102120220211b02011212221010212111011111111111111221112202020001120110211120111101111111111011
1110210111121121210112212210202121111011111110101011001111111011112221221202011b21022212100022000111111111101111222200002202022122212020212100110111000011110101
1111111102121101112111212221222211011111011111111011111110111001111221122112221b01212200012212202111111111101101022221012022122011222012212122110111110111011011
1111221111212100201112212211201022110010111111111101011111110101010201002221121a11120121201022100110111011111111022211101010220122202120212022112111111111111010
1111021212101010221111212221122122111111111110111111111111111011102212002012011a21021110020100010101111111111111110110011101011111111001111001110111111111111110
1111221111221101020111202012211101111111001101111111111011111001011022211011120b21211121002121110011011111101101222221202222202222122202002122111111111011111110
0111111111011011110112102111112102201111001011101111111111110101112021212122121b21000210220101212001101111011111111121011122022221212201210112002111101111110111
1111110111111010111101111111001011111111110010101111111111110011111101001111110a11111111110111110101001111111011012221101220222212122012212111111010111101111110
1011110111111110111111111011111011111111111011110011111111110111102010212210121a21212210121201112111111111111110222021211222220222112222012122111111111011111011
1101011111011111011101111111111110111111111001111111111111111111011212222022011a22012222012222212111111110111110020221210002222212222121202111121111111111111011
1111110011111111111111111000111101000110011111011111111011110111112222212222011b00120222221212112110101111111111220121002002202222020220112122102010011101100110
1111111000111110001010111111101110111111111110110111111111110101010120111210101b22000101222200222111101110011111110011111000001100101110110111110110111111111100
1111111111011101111011111111111110011000111111111100111111111111112212112002120a11222122211121202111011111011111001221211221221202222002112121120110111111101111
1110110011001110111011101011111111011110101101111111111111111111112111210122011b12222222210111120111111111101110122221112212201222110220212121120101111001101111
0101011111111111111001111111110111110111111111101111101110111111110212120210121b21222111011220211111111111010011112220210222002220222200010122100111011111111111
1100111111111111101011111011010111110101111111111111111111111111101111101111110a01111111110110111110111111110011011111010110011110111111011111111111111111011111
0011111011111110011111111110011101111111110111100110111110111111101002210121000b12121110020212211010111010011111012120012222022222122222222122012111111111111111
1101111011111101011011011111111011101111111110111110110101111101111220112112211b22102222011102110011111111111111222211012011022212202122200122110011001110011111
1111101111111111111011110111111111110011110111111111011101111111111202101112012a12122210111221220111111111110111222221112211121222222222222122102111110100111001
1110000111101011111011111111000110110111011111101101111101111111110010021001120b10111111102220212111010111111111200211201100111110111011101001111111111011011111
1111011010111111111111111111111011011111100111111111111111011111010222121110221b00102121212101110010100011111111110221222222222222221021210022010001111111110111
0011110111111111110111111011111101111111111101011111100101111111112221202121122a20101121101100012111111111111011222221222202112220222120002112022111111111111111
0110111111001010111111111111101110011110111110111111111011111111110211120111221a12111121101220021110111111111111112011122122112112222202222121021110111110101101
0111111111111110101110111111111100101111111111010111011111110111111212201121121a00120122212211221010111111111111010211212121201022002112121110022111111110110111
1110111110010111111111011110001000111101111011111011100110111111111112122122112b12122210211112022111111111111101111221012110102200120011121122112111101110011111
1110001111111110010111111111111111110011101010011111101111111110112012212101021b22112122221010220111111110011111112211221101211211122010212101112111111111111111
1111111011110111111111111111111011111110111101111111111111101111112221222122112b22122202010202201110110001111101110211100120112222121001210120110111111111011111
1100101001110111111111101110001111110111111010101010111111001110111111011111111a11110111100011111110100100111111012101112222211121110221022020112111111111111001
1111010111011111001111110010111111101111111110111101111101110111111111101000110aaaaaaaaaaaaaaaaaaaaaaaaaaaaaaaaaaabaaaabaaaaabbaabbbbaabbababbabbaaaaaaaaaaaaaaa
1111111011111101011111111111111111111110010011111100111111111101111011111111111111011111111111010000111111011011102221111110221221210202022111011111001111111111
0111110011111111010110111011111110011011111111011101111110011111111111111101101110101101111101110111110101001111101111101110111111111110111111101111111111111110
0011111100011011011101111110011111101111111111111111111111111111111111111111110111111111011111110111111111110111111110111101111011110110100111111011111111111110
1101111111111111111011110101110111011101111011111111110111110111111111111111011110111111111111001001111011101111111111000111111111110101101111111111111101111101
1111101111111110101101111111111011101011111101100111111011111011111111110101110111111011111110110101111011110111111111111111011101101111111101110111101111101110
0011011111111111110111011100111111111111101111111111011111111111111101110111111111111111111111111111111110110111101101111111011101111011111001011111011111111001
1111111000110111111111111110111110110111110010111101110001101111101111011111111111111101111110001100011111111011111111111111110111100011111111111110111110110111
