104,2
2,142
157,20
103,15
38,76
126,36
59,26
81,47
83,84
123,116
1011111101111111011111111111a10111111111111010111110111110111111011101011100011101101101b222022122212120122022222122221111111111111111001110101110111111a1011111
1101001101111011111111101111a11111111111111111111111111111111101101111111111111111111111a011111102112102011122222200220111011101111111111011111111011111a1110011
1011110111111111111011111111a11101111111101000111110101100101111111011111011110111111111a21121211111202002212021201100111101111111111111111110110111010a0011111
1110111111111111111111111011a10101110111111111110111111011001111110111111101101111110101b022102110012010121211101211121111111110101111111111011010011111a1011111
1110110011011111011111111111a11011100111111010111111101111011011001110011011110100101111b222210120221122212101110022011011111111111111001111111001021111a1110011
1101111111110111010111110111a11101011011111110111100101111111111111111111111111001111111b011211111212120211120122102110111111111111111111111012212002021a1222111
0111111001111111101111111111a11111111101110111111111100111111100101011111101111110111111b121122001022112222022100221221011110101011111111111111111211222b2212020
1110011010011101111101111010a11011111111011011111111101011011111111111111111110111101111a111002100121111111111110111111011011111111111011100010111101111a0212111
0111111111011111111111111101a10111101111111011111101101011101111011111111111111110010101a201001021201211101121022112221111101110111111111111101210212120a1222211
0011110111101101111110111011a11110111111111111111111111101111101111111111110110111111111a002022122121212111200211221210011111111111111011111112112221212a2222111
0111011110111111111011111101a11111101000110011101110010110111011110111111001111111111110a011211101201201110110112122121111111111111111111111012212021020b2111222
1011111111010011011111000101a01011101011111020012210210201111122202210000101101100111111a112122121111012002220220021111111101110111101110110111020222221b1112212
1001101111011001110111011111a10011111111001111112111222111221222022211122221111111111111b222201120021212221122110112121111111111111111110011012010211022b1012122
1111010111111111111111011111a10101101011111012112121210200021222210110112121111111111111b122120122021022102122200112211111011110110111101111111212100121b1210021
1110110111110111111111011111a11111111111111121110222122221100222102210102221101101111111a202011122221210222121210202010111001111011111011010112121122211b0022122
0111111110011101110110111100a11111111111101112212020211211211221212212222011111101111111b201211010220121212021221222210111111111001111010111010200222211b1111222
1111011111111110111111111111a01101001110111102011222111101101212222102221110111111011100b221002110021121211121221222220100111111111111110111112112112021a2121221
1011111111111111111111101111a11111010011111002111111022211011112221112020011111111101101b12210011212121122212210021222111101111110111110111110021111201b20120121
1111111111111011111011111111a11111100111011122211222120121121101121112122221101101111110a121222100211100022120222112211111111011101111111100111100111110a1110111
0101111100111111111011111111a11011110101100111200212221201211202110112210001111101110111a212211102101212111222020011111101010111011111110101111110011111a0111111
0111110111111111101111111111aaaaaaaaaaaaaaaabaababbbabbbaabbaaaaabababbbaabaaaaaaaaaaaaaa200222111110111010011111100101101111011110111011100011011011110b1112111
10011110111010101011111110110011111111101011200120222201211110122122111122211110110001011122111120121221021012100012021012121111221022221111212102120111a2222202
00111111111101111111111011111110110110011011001121222212100212202120020122111111101110110221222122101111111210120212210122001012022221121201122211121010a1222102
11001000100111111111111111111111111111111111111010102220120212212212101112111111111011110100121100211010021212120220201200002112021002221101020122111112a2121211
aaaaaaaaaaaaaaaaaaaaa11111101011101111111011221101102120121212100201120121111101111111102211021202110122121222120022121200111211211022122111101120022222a1222120
11111010101010111111a11011111111111111111111200001122212222212112122012120211111111001111111110110111110011111111111110101111111110111101111101111110111a1110101
11011010111010111110a11101101111110011101111122122212002220112222221021101011101101101101121212201021201222202112222221211212102112210112220110121112120a0210210
11111111101010101011a11111011111011111111110221212211211202211112112110111111111011101111111111111110122120121222212220102102112212122021221102220011211b1122121
11111111111111111111a11111011110000101111110201202210221012111102001111012211110011111012102121220102002221121112101221221121212202111210211122222122122b0222212
11111111011110111111a01111111010111111111101111111010111111012121212102121211111110111110101220121102221011012122021221202212001012121111111211120111011a2012111
11101111111111111111a11110010110101111111111022021222022210212222101121011101110101000102102112210221012002012022012221122100111211222020011201202121011b0012021
11101001110001101111a11111111011101011111101211221212121212212122120102101200011111111111111111111101101111010111102011212020212120001200111111122022211b2112200
11111111111101101101a11101111111011111110111222212122020121112011022110122222201120120002211002221101111111110100000001101120202221211122121202202111100b2212212
01111111101101100110a10111101001110111111111022200220000122212210122120122211122012111211212212211110111101001111102210221222212122222221211121211121212b1022212
11101111001010111111a11110010111111111111010220212212210102110100222021122211222102222122121212111111111011111122210201022222211201221121221111201102222a2221122
11111110101111111011a11111101101101110001011221101020200111112121112102122112122112211222022221011111001011111121221021202222111212102022101100120112122a2101220
01111011111101011111a01101011111101011011111112222020221021212111122002100212122021101221012221111111111111111121121121112002010201222210011021111110111a0110111
11111111111110111111a11111111011101111111111101222121222010102202211102102212111112222001221110121111111011111011110121222221211221121211011010111101101a1110110
11111011101110111111a11111111101011001111110222222202112102202011102122021211212111222121201000101111111111011102222220012221212212222101201000110011111a1111111
11111110111001111111a110111110011111011110112221121112221022020222221221222111211010202102212221211010110011111121122212121102100222babbabaaaaaaaaaaaaaaa1101110
11111011111011011101a111111010111111110111112222120221201221111122021121210002210011210202121222101111111011111222210211211221111112b122121121101011111011111111
00110111111111111111a111100101111110111111111110202112212120121122201211200211121121122021212211010011101101101212001110212122112222b121110022111110111111111111
01111110111111100011a010111111101111101111101100111111110011110111100020202212121122120222021210211111011111010221100110121012111222a122121102111111111100110111
11111111111110111101a111111111001111111110000111110111111111111101220221021222021100201022212221111111111111111100122110101121121022b212002121111101001111110101
11110010110111111110a111111111001111101111110011101111011111101111220111210221021110201102220212011111111111111222012212122212111220a121212111111101001111101111
11101011111111101100a111111111111000111111111111001111111000011110121101201012120020212121210212010111100111011111002212201221102210a110020112111011110011011111
10111111110011111111a101111001111110111111111111111111111111010110221100112121121111121102212121211010110111011211120210122112102220b212120120111011111111111111
11110111111111111011a111111111110111111111111111111111100111110110001111110110111222110220211211111111111111111110211001120222121110b201002121011111111101100010
11111111110111111111a111011111111101110111111011111100111111110111221001012112212222111221202120211101111101111100220111122021111112a011002022111111111111111110
10111111101110101111a101111111011110111110000111111111101111101111201121212001201210212110001002111100111011010121222012212011102020b122111121110111111111100101
11101011111111111111a011111111111110111111111101111111111001111011201020112222211212220222212120111111010111111212100112021121121002b120121022111011110111110010
11111111001011011111a010111101011011111111001011110111111111111111211121221122202121221122121121111111111111111220220002211221122220b210211010111110101111011111
01101111111110111111a111110110011100111001111111111111111111111011211200211110112112110222122011200111111110011101101111111011101111a110011111101111111111111111
11010111111001000011a001111111111111111111111011110111000110011111220221112110112002120111122021111110110011111011111110111001111111a010111111111110011111101111
00011111111111111110a011011110010111000011110101111111111110111111211211221222010112001122120121011111101110111111011111111111111111a111101110001111111101010110
01111100111110111111a011110101111111111111101111101111111111111111201211211211211212212222201222211101111111011111111111111101110111a101111111101101111110011101
11111111110111110111a111010011001111110111010111111111011111111111221021210211110222022222212222110111011111111111011111011111101101a111111101011111111111011101
00110111110110111111a100011111111111111110011011111111110101001101011121102122102212122111121211110111011101111111110111011111111000a111101111111100111111011101
00111111110111011101a111110111101110111110111110101101111111011010221221222020222211212111212200211111111111111111101111111111011011a111111111110111011011000111
11011111011111101101a111111001111111111110110001111011011111111011111100100021012221221112122212211111101111110111111101101111111110a111111111111011111111111111
11110111111110110111a111111111111011111111111111011011101111101111121220222121210221220021200221201010000110111110111011011111111111a100111001000111100101111101
11011111010100101011a111210021112110122112202212020100011111111001121222122211101221202011202212110111011110101111111111101111111111a010110111111111111011010111
11110111111111111111a110002010202212121212120221121120111011111110210021221101221212021100002201100111111111111111110111111111010111a011111111101111111011100111
11111111101101011011a112221211111221001211101120121102110100101111111101111111111010111111100101001000101111111111111010101111101111a111000111111111110110110110
01111111111111011111a111001111111111101111022111120021111111001000111111101110110110111110111111111111111111111111001011111111111110a001011011110011101111101111
11110111110111110011a101011222221111000111112221001022111101111111110110110011100011111111101110101111111011111110011111111111111111a111101111101100111111001011
00101100111101111111a110120222121122222121111120121121011101011101111111101111011111101111111001111110101101111111111111101111001110a011111011111111110111111111
11101111111111110111a112111022222221121121212202110112111011110111111011110111111111101011111001111111011111101111100111111101110111a111111111011111111011011111
11010011111111111111a112121222010102112212221020022112110011111110111111011011111111011101111111100111101111111111111110101111111110a011011101001110101111011111
11111111101111111111a111002122010012221010120210012101010011111111110112202022120112201111121112122110111001111111101111111111111111a111111101111001010001111111
01101111111100111101a101121112020110220211221121120102010111111100011211122211211222212212010022201001110011001101001111111111111111a111111011110111001011100011
01011111110101110111a102021211220202012222102211010111111101111111111221200012011002212211121201221101111110111000110000101111111110a101111011111111111111101111
11110101111111111000a112212011200100210000012020112011101101111111101112201212022220121112221221110101110101111011111111111111101111a111111111101101111111111111
11111111111010111111a112012111210121212122121022012112111011111011011222011201110122122211222200121011011111111011011111111111101101a111111101111101111111111100
11111101111101111111a111102201201220012221200011111112111111101111101001210101112221002122221211212101011111111111111010111111001010a111111010110111111000011101
11011100001111110011a112111122221021011222211010111022110111111111111221221202221222111100222022221011111111111101111111111111111101a101101011011111111111011111
11101111111101111111a112200021211211211212001011102121011001111111100122002222222022120022212111101111111110111111110111111111111100a111111111111111111101111011
11110011111011011011a111011122121212212210212112121120101111111110110020122221111111211211221122211111011111110111111111010100110111a111110111111010111101111101
01111111100111110111a102121211002102000120120120012112111011011011101111221022021011012120112211120111111111111110110110101000111111a111011111111011101011111111
11110001111010111001a111111111011112212212011112000022111111001011101102020221122112211210112102222111101001111011111111110101110110a1aaaaaaaaaaaaaaaaaaaaa11111
11011111111111111111a100210102021122022221111212111111111111111111111011020211102201212221222222120111111111101011110100111100101111a1a1111010110011111011a11111
11011110011010111011a111020121002121002122122210022111111111101100012201111222222212121011100211021111011111111110111101011010111111a1a1111111101011101110a11101
11111111111101111011a110112121011021110122111210112111111101111111112012112010121021212121212022121111111111111111110011111111011111a1a1001101111011101111a11101
11111111111100011111a111122211112102202022221212222120110011110101112022221222100000102211222020222111011111011111111100011110111100a1a1110111111101111011a10101
11111101001111101111aaababbaababbaaabaaba2101212112111011011110111012122221002012212100112221221022110111111111010111110110111111111a1a1110110110001110111a11111
1111101111111111011111111100212201121111b2111122122111111111111111112111022201021102110021222110222111111101101111101101110110100111a0a1101111111011111111a11111
1111111111111101011111101222111111201222b2001121111122110110110110011212222221210222212021212110122010101111111111101011111111011111a1a0011011111111110111a11111
0011011111101111100111112220221121211022b1102121102122101011011111111121022111222102120220110200222101111111111111011111011111101001a1a1101111101111001001a11111
1111111110111101111101001111111111110111a0101011111111111111111111111011110101011111101111111110101111011111111011110001011111111111a1a1111101111110111111a11110
1111010111011110100011111020112021111222a2121220222122110101111011112111212122121120212112020121101110111111111110101111111111101010a1a1111101011110111011a11011
1110101110111111111111112000221211021111a2121210121111011111101001010011121201212121011120120111201111111011010110111101111111111110a0a1101111111111111111a11111
0101101111010101011111122100112110111212a2221012220122111110101111110102112001011222221121202001211101111011111110011111111111111111a1a1011101001101111101a11101
1111111111011110111111111111111111111111a0101011111011111111110111001121201111220122212021221012101111111111111111011111010111111111a1a0110011011011111110a10110
0111111101111111100111101111111111101111a1111110011011111001100111110101111112200102001122021021111111111011001100001111111111111111a1a1101111111101111001a11111
1111110101111111111111111101110110111111a1111110010110111110101110111001211101202221222122222221210111110011011111111111110110101101a1a1111111110111111111a11111
1111011011111111111101100111101111111101a1111111100111011111101011011222221112211222102221122210200011111110101111111111111011111011a1a1111110111101100101a11111
0011101111110110111101111111101101011111a1111111101111111111111111110220110111211210220021111221220111111101111111011111110101111111a0a1111111111111111111a00111
0111111101111011111111111111101111001111a1110111111101111011011011111221120221121202222102222101011111111110011111111111111111111111a1a1110011110111111111a11111
1111111111111111011111111111111111111111a1100111111111111010110111111011211111211212211222122122212111101111001111100001111111111110a1a1011111111001111111a11001
1111011111110001101111111111100111011110a1101011111010010111111001111110bbbbabbbaaaabbbbabbbaabbabbaaaaaaaaaaaaaaaaaaaaaaaaaaaaaaaaaa1a1111111000111110111a11111
1110011111111111100111011111101100110111a1101111111111111111100101111111a1101011111111011100110101100111110010110010011101111111101100a1111111111111111111a01110
1111001101110110111111101110110111111111a0111111110011111111011101011101a0111100111111111011111111100111111120201211110111022122211212a1011111111111111111a11011
1111101111111110111001111111111100111111a1111011011110010111011001111111a0111111111111111111101111111111111101120212021111212110111210a1100111111111011111a10111
1101111111111110111111011111100111011111a1111011101111101111111011111011a0111111011111111111111101111101111112221122121111122221210112b2121011001001111101a11111
110010110011011111101100111101111111101a1111101111101111111111011111111a1111011111111111011011010111111100002122022011101210202022211a2011111001111110111a11010
1111111111010101111111111011111111110111a0101011111101110011111111110111a1011011111011000010101111011111111111210112211122122012111010b1011011001111110110a01011
1111111101101111111011101111101111111111a1101011110011101100110111101101a1111011101001100100101101001111010122210211111100121022212200b1121101111011110111a11111
1111111111111111111111111101110111111101a1101010111101111000111101101110a1111111111011111111111111100110111101110221121002122111112112b2121011111111110111a11110
1111110101111101111111111111111111111111a0011011111101010111011111111101a1111110111011011111111111101111111121102112221112220201112012b1111011111111111110a10100
1001101111111101110001101111011111111011a1111110011111111101011111111101a1111111010111011111011111011011101120221120220110212102210212b1121101111111001011a11111
011011111000100111011111011111011111111a1110111111011011111111111101111a0110000011111111111111111111010011121222120102121222122120212b2101111111111111101a110011
1011111111101101001001011101111110111111a1111101010111111111111110101101a1010111101111101111011100111011111111222021112000222111201012b1121110111110111011a10110
1111101111111110110111011111111101111111a1111111011110111011111111110111a0111111111111111110110101011111111001122121020002221011201211a1121011111111111001a10110
1101011111111111110001001101111011011011a1011111111111111001110110101110a1010111110101101101011110111110110121220112022101112121211112a0011111111101111111a11111
0111111111100101101111011110111110111110a1111111101001111111111111111111a1111110001111011101110111110110111122212202211002200222111112a1011111111111001101a11111
1111011111011110111101111111100101011011a1111111011110011101111101111011a0110101101111111111011111101111110110110001110111111111101111a0001011001011010011a11111
1111111011111111111111111011111111110101a1111111111111101110110011111011a0111101111111111011011101111100111022211112012122110212212011a2121001101111001011a11111
1111111110110011111111111111101111111111a1000011111110011111011111110111a1111111110011111110111110111110111102111012012220100121001112a0121110111111011110a01011
0111101111100011111111111111111110011101a1111111111111011001111101101110a1110110111111011101010101011111111012101122112201121000122011b2111101001111111110a00001
0111111110111110101011111111111011111101a1110111101011111111111111111111a0101101111011101100101111111011111122212221021002121021221201b1121111111011111111a00111
